1111111111111111111111111111111111
1P00000000000000000000000000000001
1000C000000000000000000000000C0001
1000C000000000000000000000000C0001
1000C000000000000000000000000C0001
1000C000000000000000000000000C0001
1000C000000000000000000000000C0001
1000C000000000000E00000000000C0001
1000C000000000000000000000000C0001
1000C000000000000000000000000C0001
1000C000000000000000000000000C0001
1000C000000000000000000000000C0001
1000C000000000000000000000000C0001
1000C000000000000000000000000C0001
1000C000000000000000000000000C0001
1000C000000000000000000000000C0001
1111111111111111111111111111111111