1111111111111111111111111111111111
1P000000000000000100000000000000C1
10000000000000000C0000000000000001
10000000000000000C0000000000000001
10000000000000000C0000000000000001
10000000000000000C0000000000000001
1000000000000000000000000000000001
11C0C0C0C0C000000E0000000CCCCCCC11
1000000000000000000000000000000001
10000000000000000C0000000000000001
10000000000000000C0000000000000001
10000000000000000C0000000000000001
10000000000000000C0000000000000001
10000000000000000C0000000000000001
10000000000000000C0000000000000001
10C0C0C0C0C00000010000000000000001
1111111111111111111111111111111111