1111111111111111111111111111111111
1PC00000000000000000000000000000C1
1111111111111111111111111111111101
100000000000000C0100000000000001C1
1000000000000001010000000000000101
10000000000000010100000000000001C1
1000000000000001C11111010101010101
100000000000C111CCCC1C1C1C1C1C1CC1
100000000000CCC1CEC000000000000001
100000000000C111CCCC1C1C1C1C1C1111
100000000000000111111C110101010001
10000000000000CC1CCCCC100000000001
100000000000001C1C1011100000000001
100000000000001C1C1000000000000001
100000000000001C1C1000000000000001
100000000000001CCC10000000000000C1
1111111111111111111111111111111111