1111111111111111111111111111111111111111111111
1C000000000000000000C0C00000000000000000000001
10011111111C1001111111111001111001111001001001
1000000000001000001001000001000001000001001001
1111111111001111111001001001111001001111001111
1001001001000000000000001000001001001000000001
1001001001001111111001111111111001111111001001
1000000001000001001001000001001001000001001001
1001111001111001001001111001001111111001001111
1001000001001001000001001000000001000001000001
1001111001001111111111E01111111001111001001111
1001001000001000001001000000000000000000001001
1111001001001001111001111111001111111001111001
1000000001000001001001000001001001001000000001
1111001111001111001001001111001001001001111001
1000001001001000000000000001001000000000001001
1001001001001001111001001111111001001111001001
1001001001001001001001000001000001000001001001
1111001001001001001111111001111001001111111001
1001001001000000000001000000000001000000001111
1001001001001111111001111001001111111111111001
1000000001000000001000001001000001000000000001
1001001001111111001001111111001111001111111111
1001001001000000001000000001001000000001000001
1111001111111111001111001001111111001111001001
1000001001000001001000001001000000000001001001
1001111001111001111110011001001111111111111001
1C00000001000001000000000000000000001000000001
1111111111001111001111001111001001001001001001
1000000000000000000P00000001001001000001001C11
1111111111111111111111111111111111111111111111