111111111111111111111111111111
1P0000000000000000C00000000001
100000000000000000C00000000001
1C00C1000000000000C000000000E1
10C100000000000000C00000000111
100000000000000000C00000000001
100000000000000000000000000001
111111111111111111111111111111