111111111111111111111111
1P0000000000000000000111
100000C001000000000000E1
110000000000000000000111
111111111111111111111111