111111111111111111111111111111111111111111111111111
100000000000000000000000000000000000000000000000001
10011110111100000010000011111011000CCC0100111110001
100100001001000000100000100010101100010000100000001
1E01111C10010C000C1C000C10001C10CC1CC1C00C1C1111001
100000101001000000100000100010100001010000100001001
10P111101111000000111110111110100000110000111111001
100000000000000000000000000000000000000000000000001
111111111111111111111111111111111111111111111111111