111111111111111111111111111111111111111111111111111111111111111111111
10000000000000000C0000000000000C000000000C000000000000000000000000001
100000000000000000000CCCC00000000000000C00000000000000000000000000001
10000000C000011111111111111100000000000000000C00000000000000000000001
1000C00000000000000000000000000000000000000000000CC000000000000000001
10P00000E0000C0000000000C00000CC0000001111000000000000000000000000001
10000000000C0000000000000000000000000000000000000CC000000000000000001
100000000000C00000000000000000000000000000001100000000000000000000001
100000000000000C00000000CC0000000000000011000000000000000000000000001
10000000000000C000000C00000000CC00000000000000000e0000000000000000001
100000000000000000000C000000000000000000000CC000000CC0000000000000001
1000000000000000CC0000000C0000000CC0000000000000000000000000000000001
1000000000000000000CCCCCCC0000000000000000000000000000000000000000001
111111111111111111111111111111111111111111111111111111111111111111111