111111111111111111111111111111111111111111111111111111111111111111111
1000000000000000000000000000000000000000000000000000000000000000000C1
1000000000000000000000000000000000000000000000000000000000C0000000001
100000000000011111111111111100000000000000000000000000000000000000001
100000000000000000000000000000000000000000000000000000000000000000001
10P000000000000000000000000000000000001111000000000000000000000000001
1000000000000000000000000000000000000000000000000000000000C0000000001
10000000000000000000000000C000000000000000001100000000000000000000001
100000000000000000000000000000000000000011000000000000000000000000001
1000000000000000000000000C00000000000000000000000000000000C0000000001
100000000000000000000C00000000000000000000000000000000000000000000001
100000000000000C00000000000000000000000000000000000000000000000000001
100000000000000000000000000000000000000000000000000000000000000000001
111111111111111111111111111111111111111111111111111111111111111111111