111111111111111111111111111111111111111111111111111111111111111111111
100000000000000000000000000000000000000000000000000000000000000000001
100000000000000000000000000000000000000000000000000000000000000000001
100000000000011111111111111100000000000000000000000000000000000000001
11C001E0000C0000000000111CCC00000000000000000000000000000000000000001
10P00000000000C000000000000000000000001111000000000000000000000000001
1000000000C0000000000000000000000000000000000000000000000000000000001
1000000C0000000000000000000000000000000000001100000000000000000000001
100000000000000000000000000000000000000011000000000000000000000000001
100000000000000000000000000000000000000000000000000000000000000000001
100000000000000000000000000000000000000000000000000000000000000000001
100000000000000000000000000000000000000000000000000000000000000001111
100000000000000000000000000000000000000000000000000000000000000000001
111111111111111111111111111111111111111111111111111111111111111111111