1111111
1PCCC01
100C111
100C0E1
1111111