1111111
1000101
110CCP1
1ECC011
1111111