111111111111111111111111111111111111111111111111111111111111111111111
100000000000000000000000000000000000000000000000000000000000000000001
100000000000000000000000000000000000000000000000000000000000000000001
10000000C000011111111111111100000000000000000000000000000000000000001
1000C0000000000000000000000000000000000000000000000000000000000000001
10P00000E000000000000000000000000000001111000000000000000000000000001
100000000000000000000000000000000000000000000000000000000000000000001
100000000000000000000000000000000000000000001100000000000000000000001
100000000000000000000000000000000000000011000000000000000000000000001
1000000000000000000000000000000000000000000000000e0000000000000000001
100000000000000000000000000000000000000000000000000000000000000000001
100000000000000000000000000000000000000000000000000000000000000000001
100000000000000000000000000000000000000000000000000000000000000000001
111111111111111111111111111111111111111111111111111111111111111111111