111111111111111111111111
1P0101010101010101010111
10CCCCCCCCCCCCCCCCCCCCE1
110101010101010101010111
111111111111111111111111