1111111111111111111111111111111111111111111111
1E0000100000000000CCCC000000000000000000000001
10011111111110C11111111110C1111C01111001001001
100000000C0010CC00100100C0010C0001C00001001001
1111111111C01111111C01001001111C01C01111001111
10010C100100C0C000000000100C0010C1001000000001
1001001001001111111001111111111001111111001001
10000C0001000001001001000001001001000001001001
1001111C01111C01001001111001001111111001001111
1001000001001001000001001000000001000001000001
1001111001001111111111001111111001111001001111
1001001000001C000010010000C000C000000000001001
1111C01001001001111001111111001111111C01111C01
100CC00001000001001001000001001001001000000001
1111C01111C011110010C1001111001001001C01111001
1000001C01001000C00000000001C010000C0000001001
1C01001001001001111001001111111001001111001001
1C010010010C10010010010C00010000010C0001001001
1111C01001C01001C01111111001111C01001111111001
1001001001000000000001000000000001000001001111
1C010010010C11111110C11110010C1111111111111001
1C00C000010000C000100C00100100C001001000001001
1001001001111111001001111111001111001111111111
1001001001000000001000000001001000000001000001
1111C01111111111001111001001111111001111001001
10C0001001000001001000001001000000000001001001
100111100111100111111C011001001111111111111C01
100000C00100000100C000C0C000000000001C0000C001
1111111111C01111001111001111001C01001001001001
100000000000000C000P00000001001001000001001011
1111111111111111111111111111111111111111111111