1111111111111111111111111111111111111111111111111111111111111
100100000100000000100000000000100100100000E001000001000000001
1001111001111001111111001111001001001111001111111001001111111
1000000000001001000000001000001000001000001000000001001000001
1111111001111001111001001111111111001001001001001111001111001
1001000000000000000001000000000000001001000001000001000001001
1001001111001001001001111001111001111001001111111111111001001
1001001000001001001001000000001001000001001000000000000000001
1001001111001111111001001001111001001111111111111001001001001
1000001000000001000001001001000001000001001000000001001001001
1111111111001111001111111001111001111001001001001111001111001
1001000001001000000000001001001001000000001001001000001000001
1001001001001111001111001111001111001001111001001111111001111
1000001000001000000001001000000000001001000001000000001000001
1111001111001111001111111111111111001001001111111111111001111
10010010000000010010000000000P0000001000001000000000001001001
1001001111111111001111111001111001001001001001111001001111001
1000000000001000000001001000001001001001000000001001000000001
1111001001001001111111001111111111111001111111001001111111001
1000001001001001001001001000000000000001000001001001000000001
1001001111111111001001001001111111111111111001001111111001001
1001CCCC00000000001000CC10010010CC000000001000001000000001001
1001001001111111001001001001001111001111001111111111001111111
1001C01001000000001001000000001000001001001000001000001000001
1001111001111001001111001001001111001001001001111111001001111
1000C01001000001001000001001000000001001000000000001001001001
1001111C01111111001001001001111001111001111111111111001001001
10010C0001C01001001001001001001000001000000001000001000000001
1111111001001001111001111111001001001001111111001001111001001
100000100000CCC10000010C0000001001001000001000001000001001001
1001001111001001001111001111001111111111001111111001111111001
1001001001001001000001001000000000001000000000000000000000001
10011110010011110010010C1001001111001111001111111111001001111
1001001001000001001001001001C00001000000000001001000001001001
1001001001001111111111111001001001111001111111001001111001001
1001000000000001000000001001001001000000000001000000001000001
1001001111001111111001111111C01111111111001111001111111111001
1000001000000000000000001000001000000000001000001000001000001
1001001111001111001111001111111111111001111111001111001001111
1CC1001000001000000001000000CC0000000000000001001000000000001
1111111111111111111111111111111111111111111111111111111111111