1111111111111111111111111111111111111111111111
1CCCCCCCCCCCCCCCCCCCCECCCCCCCCCCCCCCCCCCCCCCC1
1CC1111111111CC1111111111CC1111CC1111CC1CC1CC1
1CCCCCCCCCCC1CCCCC1CC1CCCCC1CCCCC1CCCCC1CC1CC1
1111111111CC1111111CC1CC1CC1111CC1CC1111CC1111
1CC1CC1CC1CCCCCCCCCCCCCC1CCCCC1CC1CC1CCCCCCCC1
1CC1CC1CC1CC1111111CC1111111111CC1111111CC1CC1
1CCCCCCCC1CCCCC1CC1CC1CCCCC1CC1CC1CCCCC1CC1CC1
1CC1111CC1111CC1CC1CC1111CC1CC1111111CC1CC1111
1CC1CCCCC1CC1CC1CCCCC1CC1CCCCCCCC1CCCCC1CCCCC1
1CC1111CC1CC1111111111CC1111111CC1111CC1CC1111
1CC1CC1CCCCC1CCCCC1CC1CCCCCCCCCCCCCCCCCCCC1CC1
1111CC1CC1CC1CC1111CC1111111CC1111111CC1111CC1
1CCCCCCCC1CCCCC1CC1CC1CCCCC1CC1CC1CC1CCCCCCCC1
1111CC1111CC1111CC1CC1CC1111CC1CC1CC1CC1111CC1
1CCCCC1CC1CC1CCCCCCCCCCCCCC1CC1CCCCCCCCCCC1CC1
1CC1CC1CC1CC1CC1111CC1CC1111111CC1CC1111CC1CC1
1CC1CC1CC1CC1CC1CC1CC1CCCCC1CCCCC1CCCCC1CC1CC1
1111CC1CC1CC1CC1CC1111111CC1111CC1CC1111111CC1
1CC1CC1CC1CCCCCCCCCCC1CCCCCCCCCCC1CCCCCCCC1111
1CC1CC1CC1CC1111111CC1111CC1CC1111111111111CC1
1CCCCCCCC1CCCCCCCC1CCCCC1CC1CCCCC1CCCCCCCCCCC1
1CC1CC1CC1111111CC1CC1111111CC1111CC1111111111
1CC1CC1CC1CCCCCCCC1CCCCCCCC1CC1CCCCCCCC1CCCCC1
1111CC1111111111CC1111CC1CC1111111CC1111CC1CC1
1CCCCC1CC1CCCCC1CC1CCCCC1CC1CCCCCCCCCCC1CC1CC1
1CC1111CC1111CC111111CC11CC1CC1111111111111CC1
1CCCCCCCC1CCCCC1CCCCCCCCCCCCCCCCCCCC1CCCCCCCC1
1111111111CC1111CC1111CC1111CC1CC1CC1CC1CC1CC1
1CCCCCCCCCCCCCCCCCCPCCCCCCC1CC1CC1CCCCC1CC1C11
1111111111111111111111111111111111111111111111