111111111111111111111111111111111111111111111111111
1CCCCCCCCCCCCCCCCCCCCCCCCCCCCCCCCCCCCCCCCCCCCCCCCC1
1CC1111CC1111CCCCC1CCCCC11111CC11CCCC1CCCC11111CCC1
1CC1CCCCC1001CCCCC1CCCCC10001CC1C1CCC1CCCC1CCCCCCC1
1EC1111CC1001CCCCC1CCCCC10001CC1CC1CC1CCCC1C1111CC1
1CCCCC1CC1001CCCCC1CCCCC10001CC1CCC1C1CCCC1CCCC1CC1
1CP1111CC1111CCCCC11111C11111CC1CCCC11CCCC111111CC1
1CCCCCCCCCCCCCCCCCCCCCCCCCCCCCCCCCCCCCCCCCCCCCCCCC1
111111111111111111111111111111111111111111111111111