11111111111111111111111111111111111111111111111111111
1000CCC00CCCC00000C00000CCCCC00CC0000C0000CCCCCCC0001
100C00000C00C00000C00000C000C00C0C000C0000C0000000001
1000CC000C00C00000C00000C000C00C00C00C0000C000CCCC0E1
100000C00C00C00000C00000C000C00C000C0C0000C000000C001
10PCCC000CCCC00000CCCCC0CCCCC00C0000CC0000CCCCCCCC001
11111111111111111111111111111111111111111111111111111